  #####
###   #
#.po  #
### o.#
#.##o #
# # . ##
#o Ooo.#
#   .  #
########