#########
#.      #
# oo    #
#     p #
#      .#
#########